{
    "TilemapSpriteSheet": "./../assets/test_tilemap_4_tiles_128x128.png",
    "Tilemap":
    [
		2, 2, 2, 2, 2, 2, 2, 2, 2, 2, 2, 2, 2, 2, 2, 2,
		2, 0, 0, 0, 0, 0, 0, 2, 2, 0, 0, 0, 0, 0, 0, 2,
		2, 0, 3, 1, 3, 1, 0, 2, 2, 0, 3, 1, 3, 1, 0, 2,
		2, 0, 1, 3, 1, 3, 0, 2, 2, 0, 1, 3, 1, 3, 0, 2,
		2, 0, 3, 1, 3, 1, 0, 2, 2, 0, 3, 1, 3, 1, 0, 2,
		2, 0, 1, 3, 1, 3, 0, 2, 2, 0, 1, 3, 1, 3, 0, 2,
		2, 0, 0, 0, 0, 0, 0, 2, 2, 0, 0, 0, 0, 0, 0, 2,
		2, 2, 2, 2, 2, 2, 2, 2, 2, 2, 2, 2, 2, 2, 2, 2,
		2, 2, 2, 2, 2, 2, 2, 2, 2, 2, 2, 2, 2, 2, 2, 2,
		2, 0, 0, 0, 0, 0, 0, 2, 2, 0, 0, 0, 0, 0, 0, 2,
		2, 0, 3, 1, 3, 1, 0, 2, 2, 0, 3, 1, 3, 1, 0, 2,
		2, 0, 1, 3, 1, 3, 0, 2, 2, 0, 1, 3, 1, 3, 0, 2,
		2, 0, 3, 1, 3, 1, 0, 2, 2, 0, 3, 1, 3, 1, 0, 2,
		2, 0, 1, 3, 1, 3, 0, 2, 2, 0, 1, 3, 1, 3, 0, 2,
		2, 0, 0, 0, 0, 0, 0, 2, 2, 0, 0, 0, 0, 0, 0, 2,
		2, 2, 2, 2, 2, 2, 2, 2, 2, 2, 2, 2, 2, 2, 2, 2
    ],
    "CollisionMap":
    [
		0, 0, 0, 0, 0, 0, 0, 0, 0, 0, 0, 0, 0, 0, 0, 0,
		0, 0, 0, 0, 0, 0, 0, 0, 0, 0, 0, 0, 0, 0, 0, 0,
		0, 0, 1, 1, 1, 1, 0, 0, 0, 0, 1, 1, 1, 1, 0, 0,
		0, 0, 1, 1, 1, 1, 0, 0, 0, 0, 1, 1, 1, 1, 0, 0,
		0, 0, 1, 1, 1, 1, 0, 0, 0, 0, 1, 1, 1, 1, 0, 0,
		0, 0, 1, 1, 1, 1, 0, 0, 0, 0, 1, 1, 1, 1, 0, 0,
		0, 0, 0, 0, 0, 0, 0, 0, 0, 0, 0, 0, 0, 0, 0, 0,
		0, 0, 0, 0, 0, 0, 0, 0, 0, 0, 0, 0, 0, 0, 0, 0,
		0, 0, 0, 0, 0, 0, 0, 0, 0, 0, 0, 0, 0, 0, 0, 0,
		0, 0, 0, 0, 0, 0, 0, 0, 0, 0, 0, 0, 0, 0, 0, 0,
		0, 0, 1, 1, 1, 1, 0, 0, 0, 0, 1, 1, 1, 1, 0, 0,
		0, 0, 1, 1, 1, 1, 0, 0, 0, 0, 1, 1, 1, 1, 0, 0,
		0, 0, 1, 1, 1, 1, 0, 0, 0, 0, 1, 1, 1, 1, 0, 0,
		0, 0, 1, 1, 1, 1, 0, 0, 0, 0, 1, 1, 1, 1, 0, 0,
		0, 0, 0, 0, 0, 0, 0, 0, 0, 0, 0, 0, 0, 0, 0, 0,
		0, 0, 0, 0, 0, 0, 0, 0, 0, 0, 0, 0, 0, 0, 0, 0
    ],
    "Entities":
    [
       {
            "Name": "Player",
            "Components": [
                { 
                    "Type": "MapCollider",
                    "Width": 64,
                    "Height": 64
                },
                { 
                    "Type": "BoxCollider",
                    "Width": 64,
                    "Height": 64
                },
                {
                    "Type": "SpriteSheet",
                    "FilePath": "./../assets/test_8dir_movement_animation_spritesheet_512x512.png",
                    "Width": 64,
                    "Height": 64
                },
                {
                    "Type": "Rigidbody",
                    "Mass": 1.0,
                    "Drag": 0.1
                }
            ]
       }
    ]
}